10000001
10000001
00110000
00110000
00000000
00000000
00001000
00001000