00000000
01100001
01100001
00000000
01100000
00001000
00001000
00000000
